#S#############
#.......#.....#
#.###.#.#.#.###
#.#.#.#.#.#...#
#.#.#.#.#.###.#
#.#.#.#.....#.#
#.#.#.#####.#.#
#...#.#.....#.#
###...#.#####.#
#...#.#.#.#...#
#.###.#...#.#.#
#.#.#...#...#.#
#.#.#########.#
#.............#
#############G#
